1111111111111
1P00001110C01
1000C00010001
1111000C000E1
1111111111111